11111111111111111111111
1000100000C0001000000C1
10001000000000000000111
100000000001000000000E1
10P00000000010000000111
10000000000010000C00001
11111111111111111111111